--N--xxx--N--
|   |xxx|   |
|   |xxx|   |
|   |xxx|   |
|   -----   |
|           |
------S------