xx--N--xx
xx|   |xx
xx|   |xx
---   ---
|       |
W       E
|       |
--S---S--