--N--
|   |
|   |
|   |
|   --------
|          |
|          E
|          |
------------