----N---
|      |
|      |
|      |
|      |
|      |
|      |
---S----