------N------
|           |
|           |
|   -----   |
|   |   |   |
|   |   |   |
|   |   |   |
|   |   |   |
--S--   --S--