xxxxxxx--N--
xxxxxxx|   |
xxxxxxx|   |
-------|   |
|          |
W          |
|          |
------------