------------
|          |
|          E
|          |
|   --------
|   |
|   |
|   |
--S--