----N-------
|          |
|          E
|          |
W      ----|
|      |
|      |
---S----