-------N--------
|              |
|              |
W              E
|              |
|              |
|              |
|              |
|              |
|              |
|              E
|              |
W              |
|              |
|              |
--------S-------