------------
|          |
W          E
|          |
--------   |
xxxxxxx|   |
xxxxxxx|   |
xxxxxxx--S--