--------
|      |
|      |
|      E
W      |
|      |
|      |
--------