------------
|          |
W          E
|          |
--------   |
       |   |
       |   |
       --S--