----N---
|      |
|      |
|      E
W      |
|      |
|      |
---S----