  --N--  
  |   |  
  |   |  
---   ---
|       |
W       E
|       |
--S---S--