       --N--
       |   |
       |   |
-------|   |
|          |
W          |
|          |
------------