--N--   --N--
|   |   |   |
|   |   |   |
|   |   |   |
|   -----   |
|           |
------S------