------------
|          |
W          E
|          |
------------