-------------
|     |    |
|     |    |
|     |    E
W     |    |
|     |    |
|     |    |
|     |    |
|     |    |
|          |
|          |
---S-----S--