------N------
|           |
|           |
|   -----   |
|   |xxx|   |
|   |xxx|   |
|   |xxx|   |
|   |xxx|   |
--S--xxx--S--